{
  "id": "debug.map",
  "rows": [
    "####################",
    "#..................#",
    "#..................#",
    "#..................#",
    "#..................#",
    "#..................#",
    "#........#.........#",
    "#........D.........#",
    "#........#.........#",
    "#..................#",
    "#..................#",
    "#..................#",
    "#..................#",
    "####################"
  ]
}
